0000000000000000220000000000000000000000000000
0000444444000000220000001111000000000000000000
0000044444000000221110000000000000000000000000
0000004444000000220000000000000000000000000000
0000004400000000220000000000000000000000000000
0000000400000000222000000000044400000000000000
0000000000000000222000000000006400000000000000
0000000000000000222200000000044400000000000000
0000033333300000222222000000000000000000000000
0000031811300000222222000000000000000000000000
0000031111300000222222000000000000000000000000
0000033133300000000000000000000000000000000000
0000000000000000000000000000000000000000000000
0000000000000000000000000000000000000000000000
0000000000000000000000000000000000000000000000